"filename", "language", "C#", "EditorConfig", "JSON", "XML", "comment", "blank", "total"
"d:\demo\Back-End\Cukcuk.Infrastructure\Cukcuk.Infrastructure.csproj", "XML", 0, 0, 0, 23, 0, 5, 28
"d:\demo\Back-End\Cukcuk.Infrastructure\Data\ApplicationDbContext.cs", "C#", 210, 0, 0, 0, 0, 44, 254
"d:\demo\Back-End\Cukcuk.Infrastructure\Repositories\CustomerGroupRepository.cs", "C#", 35, 0, 0, 0, 0, 7, 42
"d:\demo\Back-End\Cukcuk.Infrastructure\Repositories\CustomerRepository.cs", "C#", 195, 0, 0, 0, 0, 37, 232
"d:\demo\Back-End\Cukcuk.Infrastructure\Repositories\DepartmentRepository.cs", "C#", 40, 0, 0, 0, 0, 8, 48
"d:\demo\Back-End\Cukcuk.Infrastructure\Repositories\DocumentRepository.cs", "C#", 250, 0, 0, 0, 0, 68, 318
"d:\demo\Back-End\Cukcuk.Infrastructure\Repositories\EmployeeRepository.cs", "C#", 215, 0, 0, 0, 0, 37, 252
"d:\demo\Back-End\Cukcuk.Infrastructure\Repositories\ImportRepository.cs", "C#", 52, 0, 0, 0, 0, 11, 63
"d:\demo\Back-End\Cukcuk.Infrastructure\Repositories\MenuRepository.cs", "C#", 40, 0, 0, 0, 0, 8, 48
"d:\demo\Back-End\Cukcuk.Infrastructure\Repositories\MessageRepository.cs", "C#", 80, 0, 0, 0, 0, 16, 96
"d:\demo\Back-End\Cukcuk.Infrastructure\Repositories\PermissionRepository.cs", "C#", 46, 0, 0, 0, 0, 9, 55
"d:\demo\Back-End\Cukcuk.Infrastructure\Repositories\PositionRepository.cs", "C#", 39, 0, 0, 0, 0, 7, 46
"d:\demo\Back-End\Cukcuk.Infrastructure\bin\Debug\net8.0\Cukcuk.Infrastructure.deps.json", "JSON", 0, 0, 3117, 0, 0, 0, 3117
"d:\demo\Back-End\Cukcuk.Infrastructure\bin\Debug\net8.0\Cukcuk.Infrastructure.runtimeconfig.json", "JSON", 0, 0, 19, 0, 0, 0, 19
"d:\demo\Back-End\Cukcuk.Infrastructure\obj\Cukcuk.Infrastructure.csproj.EntityFrameworkCore.targets", "XML", 0, 0, 0, 28, 0, 1, 29
"d:\demo\Back-End\Cukcuk.Infrastructure\obj\Cukcuk.Infrastructure.csproj.nuget.dgspec.json", "JSON", 0, 0, 234, 0, 0, 0, 234
"d:\demo\Back-End\Cukcuk.Infrastructure\obj\Cukcuk.Infrastructure.csproj.nuget.g.props", "XML", 0, 0, 0, 25, 0, 0, 25
"d:\demo\Back-End\Cukcuk.Infrastructure\obj\Cukcuk.Infrastructure.csproj.nuget.g.targets", "XML", 0, 0, 0, 9, 0, 0, 9
"d:\demo\Back-End\Cukcuk.Infrastructure\obj\Debug\net8.0\.NETCoreApp,Version=v8.0.AssemblyAttributes.cs", "C#", 3, 0, 0, 0, 1, 1, 5
"d:\demo\Back-End\Cukcuk.Infrastructure\obj\Debug\net8.0\Cukcuk.Infrastructure.AssemblyInfo.cs", "C#", 9, 0, 0, 0, 10, 5, 24
"d:\demo\Back-End\Cukcuk.Infrastructure\obj\Debug\net8.0\Cukcuk.Infrastructure.GeneratedMSBuildEditorConfig.editorconfig", "EditorConfig", 0, 15, 0, 0, 0, 1, 16
"d:\demo\Back-End\Cukcuk.Infrastructure\obj\Debug\net8.0\Cukcuk.Infrastructure.GlobalUsings.g.cs", "C#", 7, 0, 0, 0, 1, 1, 9
"d:\demo\Back-End\Cukcuk.Infrastructure\obj\Debug\net8.0\Cukcuk.Infrastructure.sourcelink.json", "JSON", 0, 0, 1, 0, 0, 0, 1
"d:\demo\Back-End\Cukcuk.Infrastructure\obj\Release\net8.0\.NETCoreApp,Version=v8.0.AssemblyAttributes.cs", "C#", 3, 0, 0, 0, 1, 1, 5
"d:\demo\Back-End\Cukcuk.Infrastructure\obj\Release\net8.0\Cukcuk.Infrastructure.AssemblyInfo.cs", "C#", 9, 0, 0, 0, 10, 5, 24
"d:\demo\Back-End\Cukcuk.Infrastructure\obj\Release\net8.0\Cukcuk.Infrastructure.GeneratedMSBuildEditorConfig.editorconfig", "EditorConfig", 0, 13, 0, 0, 0, 1, 14
"d:\demo\Back-End\Cukcuk.Infrastructure\obj\Release\net8.0\Cukcuk.Infrastructure.GlobalUsings.g.cs", "C#", 7, 0, 0, 0, 1, 1, 9
"d:\demo\Back-End\Cukcuk.Infrastructure\obj\project.assets.json", "JSON", 0, 0, 9801, 0, 0, 0, 9801
"Total", "-", 1240, 28, 13172, 85, 24, 274, 14823